1
5
11111
12101
10001
10101
10131 